222222222222222222222222
33----------------------
222222222222222222222222
----------------------33
222222222222222222222222
3----------------------3
222222222222222222222222
