555555555566665555555555
4444444444----4444444444
4444444444----4444444444
4444444444----4444444444
5555555555----5555555555
